57,57,57,57,57,57,57,57,57,57,57,57,57,57,57,57,57,57,57,57,57,57,57,57,57
00,01,01,01,01,01,01,01,01,02,01,01,01,01,01,01,01,01,01,01,01,01,01,01,01
00,01,01,01,01,01,01,01,01,02,01,01,01,01,01,01,01,01,01,01,01,01,01,01,01
00,01,01,01,01,01,01,01,01,02,01,01,01,01,01,01,01,01,01,01,01,01,01,01,01
00,01,01,01,01,01,01,01,01,02,01,01,01,01,01,01,01,01,01,01,01,01,01,01,01
00,01,01,01,01,01,01,01,01,02,38,01,01,01,01,01,01,01,01,01,01,01,01,01,01
00,01,01,01,01,01,01,01,01,02,01,01,01,01,01,01,01,01,01,01,01,01,01,01,01
00,01,01,01,01,01,01,01,01,02,01,01,01,01,01,01,01,01,01,01,01,01,01,01,01
00,01,01,01,01,01,01,01,01,02,01,01,01,01,01,01,01,01,01,01,01,01,01,01,01
00,01,01,01,01,01,01,01,01,02,01,01,01,01,01,01,01,01,01,01,01,01,01,01,01
00,01,01,01,01,01,01,01,01,02,01,01,01,01,01,01,01,01,01,01,01,01,01,01,01
00,01,01,01,01,01,01,01,01,02,01,01,01,01,01,01,01,01,01,01,01,01,01,01,01
00,01,01,01,01,01,01,01,01,02,01,01,01,01,01,01,01,01,01,01,01,01,01,01,01
00,01,01,01,01,01,01,01,01,02,01,01,01,01,01,01,01,01,01,01,01,01,01,01,01
00,01,01,01,01,01,01,01,01,02,01,01,01,01,01,01,01,01,01,01,01,01,01,01,01
00,01,01,01,01,01,01,01,01,02,01,01,01,01,01,01,01,01,01,01,01,01,01,01,01
00,01,01,01,01,01,01,01,01,02,01,01,01,01,01,01,01,01,01,01,01,01,01,01,01
00,01,01,01,01,01,01,01,01,02,01,01,01,01,01,01,01,01,01,01,01,01,01,01,01
00,01,01,01,01,01,01,01,01,02,01,01,01,01,01,01,01,01,01,01,01,01,01,01,01
00,01,01,01,01,01,01,01,01,02,01,01,01,01,01,01,01,01,01,01,01,01,01,01,01
00,01,01,01,01,01,01,01,01,02,01,01,01,01,01,01,01,01,01,01,01,01,01,01,01
00,01,01,01,01,01,01,01,01,02,01,01,01,01,01,01,01,01,01,01,01,01,01,01,01
00,01,01,01,01,01,01,01,01,02,01,01,01,01,01,01,01,01,01,01,01,01,01,01,01
00,01,01,01,01,01,01,01,01,02,01,01,01,01,01,01,01,01,01,01,01,01,01,01,01
00,01,01,01,01,01,01,01,01,02,01,01,01,01,01,01,01,01,01,01,01,01,01,01,01